date,model_id,likes,downloads,downloads_all_time,likes_delta,downloads_delta
2025-04-09,RedHatAI/CLIP-ViT-B-32-256x256-DataComp-s34B-b86K-ds,0,0,0,0,0
2025-04-10,RedHatAI/CLIP-ViT-B-32-256x256-DataComp-s34B-b86K-ds,0,0,0,0,0
2025-04-09,RedHatAI/CLIP-ViT-B-32-256x256-DataComp-s34B-b86K-quant-ds,8,0,0,8,0
2025-04-10,RedHatAI/CLIP-ViT-B-32-256x256-DataComp-s34B-b86K-quant-ds,8,0,0,0,0
2025-04-09,RedHatAI/DeepSeek-Coder-V2-Base-FP8,0,7,507,0,507
2025-04-10,RedHatAI/DeepSeek-Coder-V2-Base-FP8,0,4,507,0,0
2025-04-09,RedHatAI/DeepSeek-Coder-V2-Instruct-FP8,7,35,29188,7,29188
2025-04-10,RedHatAI/DeepSeek-Coder-V2-Instruct-FP8,7,32,29188,0,0
2025-04-09,RedHatAI/DeepSeek-Coder-V2-Lite-Base-FP8,0,5,501,0,501
2025-04-10,RedHatAI/DeepSeek-Coder-V2-Lite-Base-FP8,0,2,501,0,0
2025-04-09,RedHatAI/DeepSeek-Coder-V2-Lite-Instruct-FP8,6,8180,55035,6,55035
2025-04-10,RedHatAI/DeepSeek-Coder-V2-Lite-Instruct-FP8,6,8094,55076,0,41
2025-04-09,RedHatAI/DeepSeek-R1-Distill-Llama-70B-FP8-dynamic,7,105641,139987,7,139987
2025-04-10,RedHatAI/DeepSeek-R1-Distill-Llama-70B-FP8-dynamic,7,103681,144378,0,4391
2025-04-09,RedHatAI/DeepSeek-R1-Distill-Llama-70B-quantized.w4a16,3,2474,12669,3,12669
2025-04-10,RedHatAI/DeepSeek-R1-Distill-Llama-70B-quantized.w4a16,3,2383,12694,0,25
2025-04-09,RedHatAI/DeepSeek-R1-Distill-Llama-70B-quantized.w8a8,1,546,2665,1,2665
2025-04-10,RedHatAI/DeepSeek-R1-Distill-Llama-70B-quantized.w8a8,1,553,2685,0,20
2025-04-09,RedHatAI/DeepSeek-R1-Distill-Llama-8B-FP8-dynamic,2,346,1972,2,1972
2025-04-10,RedHatAI/DeepSeek-R1-Distill-Llama-8B-FP8-dynamic,2,327,1972,0,0
2025-04-09,RedHatAI/DeepSeek-R1-Distill-Llama-8B-quantized.w4a16,0,404,1972,0,1972
2025-04-10,RedHatAI/DeepSeek-R1-Distill-Llama-8B-quantized.w4a16,0,383,1972,0,0
2025-04-09,RedHatAI/DeepSeek-R1-Distill-Llama-8B-quantized.w8a8,2,269,1679,2,1679
2025-04-10,RedHatAI/DeepSeek-R1-Distill-Llama-8B-quantized.w8a8,2,260,1679,0,0
2025-04-09,RedHatAI/DeepSeek-R1-Distill-Qwen-1.5B-FP8-dynamic,0,360,1474,0,1474
2025-04-10,RedHatAI/DeepSeek-R1-Distill-Qwen-1.5B-FP8-dynamic,0,352,1468,0,-6
2025-04-09,RedHatAI/DeepSeek-R1-Distill-Qwen-1.5B-quantized.w4a16,0,114,1316,0,1316
2025-04-10,RedHatAI/DeepSeek-R1-Distill-Qwen-1.5B-quantized.w4a16,0,113,1318,0,2
2025-04-09,RedHatAI/DeepSeek-R1-Distill-Qwen-1.5B-quantized.w8a8,1,324,1364,1,1364
2025-04-10,RedHatAI/DeepSeek-R1-Distill-Qwen-1.5B-quantized.w8a8,1,321,1364,0,0
2025-04-09,RedHatAI/DeepSeek-R1-Distill-Qwen-14B-FP8-dynamic,3,885,2468,3,2468
2025-04-10,RedHatAI/DeepSeek-R1-Distill-Qwen-14B-FP8-dynamic,3,851,2468,0,0
2025-04-09,RedHatAI/DeepSeek-R1-Distill-Qwen-14B-quantized.w4a16,1,1461,3141,1,3141
2025-04-10,RedHatAI/DeepSeek-R1-Distill-Qwen-14B-quantized.w4a16,1,1452,3141,0,0
2025-04-09,RedHatAI/DeepSeek-R1-Distill-Qwen-14B-quantized.w8a8,2,567,2081,2,2081
2025-04-10,RedHatAI/DeepSeek-R1-Distill-Qwen-14B-quantized.w8a8,2,565,2081,0,0
2025-04-09,RedHatAI/DeepSeek-R1-Distill-Qwen-32B-FP8-dynamic,6,1793,4412,6,4412
2025-04-10,RedHatAI/DeepSeek-R1-Distill-Qwen-32B-FP8-dynamic,6,1659,4412,0,0
2025-04-09,RedHatAI/DeepSeek-R1-Distill-Qwen-32B-quantized.w4a16,4,774,4837,4,4837
2025-04-10,RedHatAI/DeepSeek-R1-Distill-Qwen-32B-quantized.w4a16,4,751,4855,0,18
2025-04-09,RedHatAI/DeepSeek-R1-Distill-Qwen-32B-quantized.w8a8,9,906,6394,9,6394
2025-04-10,RedHatAI/DeepSeek-R1-Distill-Qwen-32B-quantized.w8a8,9,886,6413,0,19
2025-04-09,RedHatAI/DeepSeek-R1-Distill-Qwen-7B-FP8-dynamic,1,332,1242,1,1242
2025-04-10,RedHatAI/DeepSeek-R1-Distill-Qwen-7B-FP8-dynamic,1,315,1242,0,0
2025-04-09,RedHatAI/DeepSeek-R1-Distill-Qwen-7B-quantized.w4a16,2,592,1891,2,1891
2025-04-10,RedHatAI/DeepSeek-R1-Distill-Qwen-7B-quantized.w4a16,2,568,1891,0,0
2025-04-09,RedHatAI/DeepSeek-R1-Distill-Qwen-7B-quantized.w8a8,3,647,1987,3,1987
2025-04-10,RedHatAI/DeepSeek-R1-Distill-Qwen-7B-quantized.w8a8,3,647,1989,0,2
2025-04-09,RedHatAI/DeepSeek-R1-Llama-70B-quantized.w8a8,1,58,100,1,100
2025-04-10,RedHatAI/DeepSeek-R1-Llama-70B-quantized.w8a8,1,58,100,0,0
2025-04-09,RedHatAI/DeepSeek-V3-BF16,1,89,89,1,89
2025-04-10,RedHatAI/DeepSeek-V3-BF16,1,89,89,0,0
2025-04-09,RedHatAI/Llama-2-7b-chat-hf-FP8,0,125,2992,0,2992
2025-04-10,RedHatAI/Llama-2-7b-chat-hf-FP8,0,121,2992,0,0
2025-04-09,RedHatAI/Llama-2-7b-chat-quantized.w4a16,0,69,580,0,580
2025-04-10,RedHatAI/Llama-2-7b-chat-quantized.w4a16,0,64,580,0,0
2025-04-09,RedHatAI/Llama-2-7b-chat-quantized.w8a16,0,83,2159,0,2159
2025-04-10,RedHatAI/Llama-2-7b-chat-quantized.w8a16,0,79,2159,0,0
2025-04-09,RedHatAI/Llama-2-7b-chat-quantized.w8a8,1,670,4026,1,4026
2025-04-10,RedHatAI/Llama-2-7b-chat-quantized.w8a8,1,670,4030,0,4
2025-04-09,RedHatAI/Llama-2-7b-cnn-daily-mail,0,5,916,0,916
2025-04-10,RedHatAI/Llama-2-7b-cnn-daily-mail,0,3,916,0,0
2025-04-09,RedHatAI/Llama-2-7b-cnn-daily-mail-pruned_50,0,2,73,0,73
2025-04-10,RedHatAI/Llama-2-7b-cnn-daily-mail-pruned_50,0,0,73,0,0
2025-04-09,RedHatAI/Llama-2-7b-cnn-daily-mail-pruned_50-quantized-deepsparse,0,2,68,0,68
2025-04-10,RedHatAI/Llama-2-7b-cnn-daily-mail-pruned_50-quantized-deepsparse,0,0,68,0,0
2025-04-09,RedHatAI/Llama-2-7b-cnn-daily-mail-pruned_70,0,3,77,0,77
2025-04-10,RedHatAI/Llama-2-7b-cnn-daily-mail-pruned_70,0,0,77,0,0
2025-04-09,RedHatAI/Llama-2-7b-cnn-daily-mail-pruned_70-quantized-deepsparse,0,6,81,0,81
2025-04-10,RedHatAI/Llama-2-7b-cnn-daily-mail-pruned_70-quantized-deepsparse,0,3,81,0,0
2025-04-09,RedHatAI/Llama-2-7b-dolphin-open_platypus,0,3,161,0,161
2025-04-10,RedHatAI/Llama-2-7b-dolphin-open_platypus,0,1,161,0,0
2025-04-09,RedHatAI/Llama-2-7b-dolphin-open_platypus-pruned_50,0,11,195,0,195
2025-04-10,RedHatAI/Llama-2-7b-dolphin-open_platypus-pruned_50,0,7,195,0,0
2025-04-09,RedHatAI/Llama-2-7b-dolphin-open_platypus-pruned_50-quantized-deepsparse,0,6,144,0,144
2025-04-10,RedHatAI/Llama-2-7b-dolphin-open_platypus-pruned_50-quantized-deepsparse,0,1,144,0,0
2025-04-09,RedHatAI/Llama-2-7b-dolphin-open_platypus-pruned_70,0,6,365,0,365
2025-04-10,RedHatAI/Llama-2-7b-dolphin-open_platypus-pruned_70,0,2,365,0,0
2025-04-09,RedHatAI/Llama-2-7b-dolphin-open_platypus-pruned_70-quantized-deepsparse,1,7,135,1,135
2025-04-10,RedHatAI/Llama-2-7b-dolphin-open_platypus-pruned_70-quantized-deepsparse,1,3,135,0,0
2025-04-09,RedHatAI/Llama-2-7b-evol-code-alpaca-pruned_50,0,13,190,0,190
2025-04-10,RedHatAI/Llama-2-7b-evol-code-alpaca-pruned_50,0,10,190,0,0
2025-04-09,RedHatAI/Llama-2-7b-evol-code-alpaca-pruned_50-quantized-deepsparse,0,4,137,0,137
2025-04-10,RedHatAI/Llama-2-7b-evol-code-alpaca-pruned_50-quantized-deepsparse,0,2,137,0,0
2025-04-09,RedHatAI/Llama-2-7b-evol-code-alpaca-pruned_70,0,6,163,0,163
2025-04-10,RedHatAI/Llama-2-7b-evol-code-alpaca-pruned_70,0,2,163,0,0
2025-04-09,RedHatAI/Llama-2-7b-evol-code-alpaca-pruned_70-quantized-deepsparse,0,2,120,0,120
2025-04-10,RedHatAI/Llama-2-7b-evol-code-alpaca-pruned_70-quantized-deepsparse,0,0,120,0,0
2025-04-09,RedHatAI/Llama-2-7b-evolcodealpaca,1,14,27408,1,27408
2025-04-10,RedHatAI/Llama-2-7b-evolcodealpaca,1,10,27408,0,0
2025-04-09,RedHatAI/Llama-2-7b-gsm8k,3,1217,47068,3,47068
2025-04-10,RedHatAI/Llama-2-7b-gsm8k,3,1219,47105,0,37
2025-04-09,RedHatAI/Llama-2-7b-gsm8k-pruned_50,1,6,188,1,188
2025-04-10,RedHatAI/Llama-2-7b-gsm8k-pruned_50,1,4,188,0,0
2025-04-09,RedHatAI/Llama-2-7b-gsm8k-pruned_70,0,4,136,0,136
2025-04-10,RedHatAI/Llama-2-7b-gsm8k-pruned_70,0,2,136,0,0
2025-04-09,RedHatAI/Llama-2-7b-pruned50-retrained,0,75,3897,0,3897
2025-04-10,RedHatAI/Llama-2-7b-pruned50-retrained,0,69,3897,0,0
2025-04-09,RedHatAI/Llama-2-7b-pruned70-retrained,0,3,2803,0,2803
2025-04-10,RedHatAI/Llama-2-7b-pruned70-retrained,0,1,2803,0,0
2025-04-09,RedHatAI/Llama-2-7b-ultrachat200k,0,1436,9663,0,9663
2025-04-10,RedHatAI/Llama-2-7b-ultrachat200k,0,1446,9699,0,36
2025-04-09,RedHatAI/Llama-2-7b-ultrachat200k-pruned_50,0,8,502,0,502
2025-04-10,RedHatAI/Llama-2-7b-ultrachat200k-pruned_50,0,6,502,0,0
2025-04-09,RedHatAI/Llama-2-7b-ultrachat200k-pruned_50-quantized-deepsparse,0,7,124,0,124
2025-04-10,RedHatAI/Llama-2-7b-ultrachat200k-pruned_50-quantized-deepsparse,0,5,124,0,0
2025-04-09,RedHatAI/Llama-2-7b-ultrachat200k-pruned_70,0,21,885,0,885
2025-04-10,RedHatAI/Llama-2-7b-ultrachat200k-pruned_70,0,15,885,0,0
2025-04-09,RedHatAI/Llama-2-7b-ultrachat200k-pruned_70-quantized-deepsparse,0,5,273,0,273
2025-04-10,RedHatAI/Llama-2-7b-ultrachat200k-pruned_70-quantized-deepsparse,0,1,273,0,0
2025-04-09,RedHatAI/Llama-3.1-8B-evolcodealpaca,0,3,33,0,33
2025-04-10,RedHatAI/Llama-3.1-8B-evolcodealpaca,0,1,33,0,0
2025-04-09,RedHatAI/Llama-3.1-8B-gsm8k,0,6,55,0,55
2025-04-10,RedHatAI/Llama-3.1-8B-gsm8k,0,3,55,0,0
2025-04-09,RedHatAI/Llama-3.1-8B-ultrachat_200k,0,4,70,0,70
2025-04-10,RedHatAI/Llama-3.1-8B-ultrachat_200k,0,2,70,0,0
2025-04-09,RedHatAI/Llama-3.1-Nemotron-70B-Instruct-HF-FP8-dynamic,14,1041,109009,14,109009
2025-04-10,RedHatAI/Llama-3.1-Nemotron-70B-Instruct-HF-FP8-dynamic,14,1057,109029,0,20
2025-04-09,RedHatAI/Llama-3.2-11B-Vision-Instruct-FP8-dynamic,22,4702,268712,22,268712
2025-04-10,RedHatAI/Llama-3.2-11B-Vision-Instruct-FP8-dynamic,22,4687,268712,0,0
2025-04-09,RedHatAI/Llama-3.2-11B-Vision-Instruct-quantized.w4a16,0,1539,1984,0,1984
2025-04-10,RedHatAI/Llama-3.2-11B-Vision-Instruct-quantized.w4a16,0,1496,1986,0,2
2025-04-09,RedHatAI/Llama-3.2-1B-FP8,0,30,938,0,938
2025-04-10,RedHatAI/Llama-3.2-1B-FP8,0,28,938,0,0
2025-04-09,RedHatAI/Llama-3.2-1B-Instruct-FP8,2,7404,300189,2,300189
2025-04-10,RedHatAI/Llama-3.2-1B-Instruct-FP8,2,7368,300201,0,12
2025-04-09,RedHatAI/Llama-3.2-1B-Instruct-FP8-dynamic,3,128974,170298,3,170298
2025-04-10,RedHatAI/Llama-3.2-1B-Instruct-FP8-dynamic,3,136523,178386,0,8088
2025-04-09,RedHatAI/Llama-3.2-1B-Instruct-quantized.w8a8,7,6167,26151,7,26151
2025-04-10,RedHatAI/Llama-3.2-1B-Instruct-quantized.w8a8,7,6006,26175,0,24
2025-04-09,RedHatAI/Llama-3.2-1B-quantized.w8a8,0,2359,8562,0,8562
2025-04-10,RedHatAI/Llama-3.2-1B-quantized.w8a8,0,2326,8566,0,4
2025-04-09,RedHatAI/Llama-3.2-3B-Instruct-FP8,6,65774,144635,6,144635
2025-04-10,RedHatAI/Llama-3.2-3B-Instruct-FP8,6,64541,144183,0,-452
2025-04-09,RedHatAI/Llama-3.2-3B-Instruct-FP8-dynamic,2,31504,47314,2,47314
2025-04-10,RedHatAI/Llama-3.2-3B-Instruct-FP8-dynamic,2,35639,51456,0,4142
2025-04-09,RedHatAI/Llama-3.2-3B-Instruct-quantized.w8a8,1,3132,34074,1,34074
2025-04-10,RedHatAI/Llama-3.2-3B-Instruct-quantized.w8a8,1,3173,34130,0,56
2025-04-09,RedHatAI/Llama-3.2-3B-quantized.w8a8,0,2,318,0,318
2025-04-10,RedHatAI/Llama-3.2-3B-quantized.w8a8,0,0,318,0,0
2025-04-09,RedHatAI/Llama-3.2-90B-Vision-Instruct-FP8-dynamic,10,49749,147096,10,147096
2025-04-10,RedHatAI/Llama-3.2-90B-Vision-Instruct-FP8-dynamic,10,45249,147066,0,-30
2025-04-09,RedHatAI/Llama-3.3-70B-Instruct-quantized.w8a8,5,3938,13781,5,13781
2025-04-10,RedHatAI/Llama-3.3-70B-Instruct-quantized.w8a8,5,3766,13806,0,25
2025-04-09,RedHatAI/Llama2-7b-chat-pruned50-quant-ds,9,8,496,9,496
2025-04-10,RedHatAI/Llama2-7b-chat-pruned50-quant-ds,9,7,496,0,0
2025-04-09,RedHatAI/Meta-Llama-3-70B-Instruct-FP8,11,21112,336751,11,336751
2025-04-10,RedHatAI/Meta-Llama-3-70B-Instruct-FP8,11,19841,336847,0,96
2025-04-09,RedHatAI/Meta-Llama-3-70B-Instruct-FP8-KV,2,243,4137,2,4137
2025-04-10,RedHatAI/Meta-Llama-3-70B-Instruct-FP8-KV,2,239,4137,0,0
2025-04-09,RedHatAI/Meta-Llama-3-70B-Instruct-quantized.w4a16,2,32,569850,2,569850
2025-04-10,RedHatAI/Meta-Llama-3-70B-Instruct-quantized.w4a16,2,30,569850,0,0
2025-04-09,RedHatAI/Meta-Llama-3-70B-Instruct-quantized.w8a16,4,1680,5029,4,5029
2025-04-10,RedHatAI/Meta-Llama-3-70B-Instruct-quantized.w8a16,4,1665,5031,0,2
2025-04-09,RedHatAI/Meta-Llama-3-70B-Instruct-quantized.w8a8,0,14,443,0,443
2025-04-10,RedHatAI/Meta-Llama-3-70B-Instruct-quantized.w8a8,0,12,443,0,0
2025-04-09,RedHatAI/Meta-Llama-3-8B-Instruct-FP8,23,13008,123945,23,123945
2025-04-10,RedHatAI/Meta-Llama-3-8B-Instruct-FP8,23,13152,124111,0,166
2025-04-09,RedHatAI/Meta-Llama-3-8B-Instruct-FP8-KV,7,4994,89230,7,89230
2025-04-10,RedHatAI/Meta-Llama-3-8B-Instruct-FP8-KV,7,4934,89222,0,-8
2025-04-09,RedHatAI/Meta-Llama-3-8B-Instruct-quantized.w4a16,2,266,3184,2,3184
2025-04-10,RedHatAI/Meta-Llama-3-8B-Instruct-quantized.w4a16,2,262,3184,0,0
2025-04-09,RedHatAI/Meta-Llama-3-8B-Instruct-quantized.w8a16,3,536,107152,3,107152
2025-04-10,RedHatAI/Meta-Llama-3-8B-Instruct-quantized.w8a16,3,525,107152,0,0
2025-04-09,RedHatAI/Meta-Llama-3-8B-Instruct-quantized.w8a8,2,3375,39026,2,39026
2025-04-10,RedHatAI/Meta-Llama-3-8B-Instruct-quantized.w8a8,2,3310,39048,0,22
2025-04-09,RedHatAI/Meta-Llama-3.1-405B-FP8,0,85,569,0,569
2025-04-10,RedHatAI/Meta-Llama-3.1-405B-FP8,0,109,597,0,28
2025-04-09,RedHatAI/Meta-Llama-3.1-405B-Instruct-FP8,31,566,27807,31,27807
2025-04-10,RedHatAI/Meta-Llama-3.1-405B-Instruct-FP8,31,562,27807,0,0
2025-04-09,RedHatAI/Meta-Llama-3.1-405B-Instruct-FP8-dynamic,14,187,3434,14,3434
2025-04-10,RedHatAI/Meta-Llama-3.1-405B-Instruct-FP8-dynamic,14,183,3434,0,0
2025-04-09,RedHatAI/Meta-Llama-3.1-405B-Instruct-quantized.w4a16,12,2185,19143,12,19143
2025-04-10,RedHatAI/Meta-Llama-3.1-405B-Instruct-quantized.w4a16,12,2017,18982,0,-161
2025-04-09,RedHatAI/Meta-Llama-3.1-405B-Instruct-quantized.w8a16,2,63,1824,2,1824
2025-04-10,RedHatAI/Meta-Llama-3.1-405B-Instruct-quantized.w8a16,2,56,1824,0,0
2025-04-09,RedHatAI/Meta-Llama-3.1-405B-Instruct-quantized.w8a8,2,173,3473,2,3473
2025-04-10,RedHatAI/Meta-Llama-3.1-405B-Instruct-quantized.w8a8,2,169,3473,0,0
2025-04-09,RedHatAI/Meta-Llama-3.1-70B-FP8,1,453,3759,1,3759
2025-04-10,RedHatAI/Meta-Llama-3.1-70B-FP8,1,449,3759,0,0
2025-04-09,RedHatAI/Meta-Llama-3.1-70B-Instruct-FP8,42,306854,753218,42,753218
2025-04-10,RedHatAI/Meta-Llama-3.1-70B-Instruct-FP8,42,300245,753370,0,152
2025-04-09,RedHatAI/Meta-Llama-3.1-70B-Instruct-FP8-dynamic,6,4961,21811,6,21811
2025-04-10,RedHatAI/Meta-Llama-3.1-70B-Instruct-FP8-dynamic,6,4960,21813,0,2
2025-04-09,RedHatAI/Meta-Llama-3.1-70B-Instruct-quantized.w4a16,32,11218,454377,32,454377
2025-04-10,RedHatAI/Meta-Llama-3.1-70B-Instruct-quantized.w4a16,32,11151,454390,0,13
2025-04-09,RedHatAI/Meta-Llama-3.1-70B-Instruct-quantized.w8a16,5,87,5230,5,5230
2025-04-10,RedHatAI/Meta-Llama-3.1-70B-Instruct-quantized.w8a16,5,89,5236,0,6
2025-04-09,RedHatAI/Meta-Llama-3.1-70B-Instruct-quantized.w8a8,19,6569,78970,19,78970
2025-04-10,RedHatAI/Meta-Llama-3.1-70B-Instruct-quantized.w8a8,19,6534,78978,0,8
2025-04-09,RedHatAI/Meta-Llama-3.1-70B-quantized.w8a16,0,2,81,0,81
2025-04-10,RedHatAI/Meta-Llama-3.1-70B-quantized.w8a16,0,0,81,0,0
2025-04-09,RedHatAI/Meta-Llama-3.1-70B-quantized.w8a8,0,42,158,0,158
2025-04-10,RedHatAI/Meta-Llama-3.1-70B-quantized.w8a8,0,40,158,0,0
2025-04-09,RedHatAI/Meta-Llama-3.1-8B-FP8,6,3816,34709,6,34709
2025-04-10,RedHatAI/Meta-Llama-3.1-8B-FP8,6,3712,34709,0,0
2025-04-09,RedHatAI/Meta-Llama-3.1-8B-Instruct-FP8,41,91684,1352929,41,1352929
2025-04-10,RedHatAI/Meta-Llama-3.1-8B-Instruct-FP8,41,91229,1353418,0,489
2025-04-09,RedHatAI/Meta-Llama-3.1-8B-Instruct-FP8-dynamic,5,17257,43937,5,43937
2025-04-10,RedHatAI/Meta-Llama-3.1-8B-Instruct-FP8-dynamic,5,17641,44338,0,401
2025-04-09,RedHatAI/Meta-Llama-3.1-8B-Instruct-quantized.w4a16,26,169125,926828,26,926828
2025-04-10,RedHatAI/Meta-Llama-3.1-8B-Instruct-quantized.w4a16,26,167287,927435,0,607
2025-04-09,RedHatAI/Meta-Llama-3.1-8B-Instruct-quantized.w8a16,10,12568,46647,10,46647
2025-04-10,RedHatAI/Meta-Llama-3.1-8B-Instruct-quantized.w8a16,10,12655,46740,0,93
2025-04-09,RedHatAI/Meta-Llama-3.1-8B-Instruct-quantized.w8a8,14,15241,75000,14,75000
2025-04-10,RedHatAI/Meta-Llama-3.1-8B-Instruct-quantized.w8a8,14,14585,75068,0,68
2025-04-09,RedHatAI/Meta-Llama-3.1-8B-quantized.w8a16,1,135,36624,1,36624
2025-04-10,RedHatAI/Meta-Llama-3.1-8B-quantized.w8a16,1,123,36624,0,0
2025-04-09,RedHatAI/Meta-Llama-3.1-8B-quantized.w8a8,2,499,4043,2,4043
2025-04-10,RedHatAI/Meta-Llama-3.1-8B-quantized.w8a8,3,360,4043,1,0
2025-04-09,RedHatAI/MiniChat-1.5-3B-pruned50-quant-ds,1,11,300,1,300
2025-04-10,RedHatAI/MiniChat-1.5-3B-pruned50-quant-ds,1,9,300,0,0
2025-04-09,RedHatAI/MiniChat-2-3B-pruned2.4,0,13,309,0,309
2025-04-10,RedHatAI/MiniChat-2-3B-pruned2.4,0,9,309,0,0
2025-04-09,RedHatAI/MiniChat-3B-pruned50-quant-ds,0,4,286,0,286
2025-04-10,RedHatAI/MiniChat-3B-pruned50-quant-ds,0,3,286,0,0
2025-04-09,RedHatAI/Mistral-7B-Instruct-v0.3-FP8,2,431,10053,2,10053
2025-04-10,RedHatAI/Mistral-7B-Instruct-v0.3-FP8,2,395,10057,0,4
2025-04-09,RedHatAI/Mistral-7B-Instruct-v0.3-GPTQ-4bit,18,3735,425287,18,425287
2025-04-10,RedHatAI/Mistral-7B-Instruct-v0.3-GPTQ-4bit,18,3638,425346,0,59
2025-04-09,RedHatAI/Mistral-7B-Instruct-v0.3-quantized.w4a16,1,151,2181,1,2181
2025-04-10,RedHatAI/Mistral-7B-Instruct-v0.3-quantized.w4a16,1,147,2181,0,0
2025-04-09,RedHatAI/Mistral-7B-Instruct-v0.3-quantized.w8a16,0,571,5257,0,5257
2025-04-10,RedHatAI/Mistral-7B-Instruct-v0.3-quantized.w8a16,0,566,5257,0,0
2025-04-09,RedHatAI/Mistral-7B-Instruct-v0.3-quantized.w8a8,2,135,2017,2,2017
2025-04-10,RedHatAI/Mistral-7B-Instruct-v0.3-quantized.w8a8,2,79,2017,0,0
2025-04-09,RedHatAI/Mistral-Nemo-Instruct-2407-FP8,18,9655,173606,18,173606
2025-04-10,RedHatAI/Mistral-Nemo-Instruct-2407-FP8,18,8369,173614,0,8
2025-04-09,RedHatAI/Mistral-Nemo-Instruct-2407-quantized.w4a16,4,259,31529,4,31529
2025-04-10,RedHatAI/Mistral-Nemo-Instruct-2407-quantized.w4a16,4,248,31532,0,3
2025-04-09,RedHatAI/Mistral-Nemo-Instruct-2407-quantized.w8a16,0,0,2,0,2
2025-04-10,RedHatAI/Mistral-Nemo-Instruct-2407-quantized.w8a16,0,0,2,0,0
2025-04-09,RedHatAI/Mistral-Small-24B-Instruct-2501-FP8-Dynamic,12,214349,449227,12,449227
2025-04-10,RedHatAI/Mistral-Small-24B-Instruct-2501-FP8-Dynamic,12,214346,449637,0,410
2025-04-09,RedHatAI/Mixtral-8x22B-Instruct-v0.1-AutoFP8,3,103,4657,3,4657
2025-04-10,RedHatAI/Mixtral-8x22B-Instruct-v0.1-AutoFP8,3,99,4657,0,0
2025-04-09,RedHatAI/Mixtral-8x22B-Instruct-v0.1-FP8,0,108,1218,0,1218
2025-04-10,RedHatAI/Mixtral-8x22B-Instruct-v0.1-FP8,0,107,1218,0,0
2025-04-09,RedHatAI/Mixtral-8x7B-Instruct-v0.1-AutoFP8,3,81,30447,3,30447
2025-04-10,RedHatAI/Mixtral-8x7B-Instruct-v0.1-AutoFP8,3,75,30447,0,0
2025-04-09,RedHatAI/Mixtral-8x7B-Instruct-v0.1-FP8,0,423,2707,0,2707
2025-04-10,RedHatAI/Mixtral-8x7B-Instruct-v0.1-FP8,0,411,2713,0,6
2025-04-09,RedHatAI/Nous-Hermes-2-SOLAR-10.7B-pruned2.4,0,2,175,0,175
2025-04-10,RedHatAI/Nous-Hermes-2-SOLAR-10.7B-pruned2.4,0,1,175,0,0
2025-04-09,RedHatAI/Nous-Hermes-2-SOLAR-10.7B-pruned50-quant-ds,7,0,137,7,137
2025-04-10,RedHatAI/Nous-Hermes-2-SOLAR-10.7B-pruned50-quant-ds,7,0,137,0,0
2025-04-09,RedHatAI/Nous-Hermes-2-Yi-34B-marlin,5,7,172,5,172
2025-04-10,RedHatAI/Nous-Hermes-2-Yi-34B-marlin,5,5,172,0,0
2025-04-09,RedHatAI/Nous-Hermes-2-Yi-34B-pruned2.4,0,0,149,0,149
2025-04-10,RedHatAI/Nous-Hermes-2-Yi-34B-pruned2.4,0,0,149,0,0
2025-04-09,RedHatAI/Nous-Hermes-2-Yi-34B-pruned50,0,2,140,0,140
2025-04-10,RedHatAI/Nous-Hermes-2-Yi-34B-pruned50,0,1,140,0,0
2025-04-09,RedHatAI/Nous-Hermes-llama-2-7b-pruned50-quant-ds,0,0,140,0,140
2025-04-10,RedHatAI/Nous-Hermes-llama-2-7b-pruned50-quant-ds,0,0,140,0,0
2025-04-09,RedHatAI/OpenHermes-2.5-Mistral-7B-marlin,2,680,10844,2,10844
2025-04-10,RedHatAI/OpenHermes-2.5-Mistral-7B-marlin,2,661,10844,0,0
2025-04-09,RedHatAI/OpenHermes-2.5-Mistral-7B-pruned2.4,0,5,10734,0,10734
2025-04-10,RedHatAI/OpenHermes-2.5-Mistral-7B-pruned2.4,0,5,10734,0,0
2025-04-09,RedHatAI/OpenHermes-2.5-Mistral-7B-pruned50,1,7,12233,1,12233
2025-04-10,RedHatAI/OpenHermes-2.5-Mistral-7B-pruned50,1,7,12233,0,0
2025-04-09,RedHatAI/OpenHermes-2.5-Mistral-7B-pruned50-quant-ds,2,10,422,2,422
2025-04-10,RedHatAI/OpenHermes-2.5-Mistral-7B-pruned50-quant-ds,2,6,422,0,0
2025-04-09,RedHatAI/Phi-3-medium-128k-instruct-FP8,5,0,43260,5,43260
2025-04-10,RedHatAI/Phi-3-medium-128k-instruct-FP8,5,0,43260,0,0
2025-04-09,RedHatAI/Phi-3-medium-128k-instruct-quantized.w4a16,3,4049,481954,3,481954
2025-04-10,RedHatAI/Phi-3-medium-128k-instruct-quantized.w4a16,3,3950,481942,0,-12
2025-04-09,RedHatAI/Phi-3-medium-128k-instruct-quantized.w8a16,2,0,9865,2,9865
2025-04-10,RedHatAI/Phi-3-medium-128k-instruct-quantized.w8a16,2,0,9865,0,0
2025-04-09,RedHatAI/Phi-3-medium-128k-instruct-quantized.w8a8,2,0,2419,2,2419
2025-04-10,RedHatAI/Phi-3-medium-128k-instruct-quantized.w8a8,2,0,2419,0,0
2025-04-09,RedHatAI/Phi-3-mini-128k-instruct-FP8,0,0,8731,0,8731
2025-04-10,RedHatAI/Phi-3-mini-128k-instruct-FP8,0,0,8731,0,0
2025-04-09,RedHatAI/Phi-3-mini-128k-instruct-quantized.w4a16,1,0,1791,1,1791
2025-04-10,RedHatAI/Phi-3-mini-128k-instruct-quantized.w4a16,1,0,1791,0,0
2025-04-09,RedHatAI/Phi-3-mini-128k-instruct-quantized.w8a16,0,0,200,0,200
2025-04-10,RedHatAI/Phi-3-mini-128k-instruct-quantized.w8a16,0,0,200,0,0
2025-04-09,RedHatAI/Phi-3-mini-128k-instruct-quantized.w8a8,0,0,1503,0,1503
2025-04-10,RedHatAI/Phi-3-mini-128k-instruct-quantized.w8a8,0,0,1503,0,0
2025-04-09,RedHatAI/Phi-3-small-128k-instruct-quantized.w8a16,0,0,1310,0,1310
2025-04-10,RedHatAI/Phi-3-small-128k-instruct-quantized.w8a16,0,0,1310,0,0
2025-04-09,RedHatAI/Phi-3-vision-128k-instruct-W4A16-G128,1,56,359,1,359
2025-04-10,RedHatAI/Phi-3-vision-128k-instruct-W4A16-G128,1,53,359,0,0
2025-04-09,RedHatAI/Phi-3.5-mini-instruct-FP8-KV,2,828,2287,2,2287
2025-04-10,RedHatAI/Phi-3.5-mini-instruct-FP8-KV,2,822,2287,0,0
2025-04-09,RedHatAI/Pixtral-Large-Instruct-2411-hf-FP8-dynamic,0,19,162,0,162
2025-04-10,RedHatAI/Pixtral-Large-Instruct-2411-hf-FP8-dynamic,0,17,162,0,0
2025-04-09,RedHatAI/Pixtral-Large-Instruct-2411-hf-quantized.w4a16,0,103,659,0,659
2025-04-10,RedHatAI/Pixtral-Large-Instruct-2411-hf-quantized.w4a16,0,100,659,0,0
2025-04-09,RedHatAI/Pixtral-Large-Instruct-2411-hf-quantized.w8a8,0,24,300,0,300
2025-04-10,RedHatAI/Pixtral-Large-Instruct-2411-hf-quantized.w8a8,0,24,300,0,0
2025-04-09,RedHatAI/Qwen2-0.5B-Instruct-FP8,3,7247,15762,3,15762
2025-04-10,RedHatAI/Qwen2-0.5B-Instruct-FP8,3,7230,15811,0,49
2025-04-09,RedHatAI/Qwen2-0.5B-Instruct-quantized.w4a16,0,116,2623,0,2623
2025-04-10,RedHatAI/Qwen2-0.5B-Instruct-quantized.w4a16,0,112,2623,0,0
2025-04-09,RedHatAI/Qwen2-0.5B-Instruct-quantized.w8a16,0,67,543,0,543
2025-04-10,RedHatAI/Qwen2-0.5B-Instruct-quantized.w8a16,0,65,545,0,2
2025-04-09,RedHatAI/Qwen2-0.5B-Instruct-quantized.w8a8,0,138,1374,0,1374
2025-04-10,RedHatAI/Qwen2-0.5B-Instruct-quantized.w8a8,0,137,1378,0,4
2025-04-09,RedHatAI/Qwen2-1.5B-Instruct-FP8,0,3878,8713,0,8713
2025-04-10,RedHatAI/Qwen2-1.5B-Instruct-FP8,0,3807,8712,0,-1
2025-04-09,RedHatAI/Qwen2-1.5B-Instruct-quantized.w4a16,0,89,1507,0,1507
2025-04-10,RedHatAI/Qwen2-1.5B-Instruct-quantized.w4a16,0,85,1507,0,0
2025-04-09,RedHatAI/Qwen2-1.5B-Instruct-quantized.w8a16,0,86,489,0,489
2025-04-10,RedHatAI/Qwen2-1.5B-Instruct-quantized.w8a16,0,82,489,0,0
2025-04-09,RedHatAI/Qwen2-1.5B-Instruct-quantized.w8a8,0,1217,17436,0,17436
2025-04-10,RedHatAI/Qwen2-1.5B-Instruct-quantized.w8a8,0,1198,17436,0,0
2025-04-09,RedHatAI/Qwen2-57B-A14B-Instruct-FP8,1,540,3711,1,3711
2025-04-10,RedHatAI/Qwen2-57B-A14B-Instruct-FP8,1,537,3717,0,6
2025-04-09,RedHatAI/Qwen2-72B-Instruct-FP8,15,549,5300,15,5300
2025-04-10,RedHatAI/Qwen2-72B-Instruct-FP8,15,548,5306,0,6
2025-04-09,RedHatAI/Qwen2-72B-Instruct-quantized.w4a16,4,13,2058,4,2058
2025-04-10,RedHatAI/Qwen2-72B-Instruct-quantized.w4a16,4,9,2058,0,0
2025-04-09,RedHatAI/Qwen2-72B-Instruct-quantized.w8a16,1,51,1606,1,1606
2025-04-10,RedHatAI/Qwen2-72B-Instruct-quantized.w8a16,1,49,1606,0,0
2025-04-09,RedHatAI/Qwen2-72B-Instruct-quantized.w8a8,1,7,1744,1,1744
2025-04-10,RedHatAI/Qwen2-72B-Instruct-quantized.w8a8,1,5,1744,0,0
2025-04-09,RedHatAI/Qwen2-7B-Instruct-FP8,2,8593,22283,2,22283
2025-04-10,RedHatAI/Qwen2-7B-Instruct-FP8,2,8447,22258,0,-25
2025-04-09,RedHatAI/Qwen2-7B-Instruct-quantized.w4a16,0,177,3542,0,3542
2025-04-10,RedHatAI/Qwen2-7B-Instruct-quantized.w4a16,0,173,3542,0,0
2025-04-09,RedHatAI/Qwen2-7B-Instruct-quantized.w8a16,0,30,449,0,449
2025-04-10,RedHatAI/Qwen2-7B-Instruct-quantized.w8a16,0,28,449,0,0
2025-04-09,RedHatAI/Qwen2-7B-Instruct-quantized.w8a8,0,461,4942,0,4942
2025-04-10,RedHatAI/Qwen2-7B-Instruct-quantized.w8a8,0,459,4942,0,0
2025-04-09,RedHatAI/Qwen2-VL-72B-Instruct-FP8-dynamic,0,26,1848,0,1848
2025-04-10,RedHatAI/Qwen2-VL-72B-Instruct-FP8-dynamic,0,19,1848,0,0
2025-04-09,RedHatAI/Qwen2-VL-72B-Instruct-quantized.w4a16,0,121,626,0,626
2025-04-10,RedHatAI/Qwen2-VL-72B-Instruct-quantized.w4a16,0,113,626,0,0
2025-04-09,RedHatAI/Qwen2-VL-72B-Instruct-quantized.w8a8,0,56,323,0,323
2025-04-10,RedHatAI/Qwen2-VL-72B-Instruct-quantized.w8a8,0,46,323,0,0
2025-04-09,RedHatAI/Qwen2.5-0.5B-FP8-dynamic,0,22,136,0,136
2025-04-10,RedHatAI/Qwen2.5-0.5B-FP8-dynamic,0,20,136,0,0
2025-04-09,RedHatAI/Qwen2.5-0.5B-Instruct-quantized.w8a8,0,36,186,0,186
2025-04-10,RedHatAI/Qwen2.5-0.5B-Instruct-quantized.w8a8,0,32,186,0,0
2025-04-09,RedHatAI/Qwen2.5-0.5B-quantized.w8a16,0,24,96,0,96
2025-04-10,RedHatAI/Qwen2.5-0.5B-quantized.w8a16,0,22,96,0,0
2025-04-09,RedHatAI/Qwen2.5-0.5B-quantized.w8a8,0,15,62,0,62
2025-04-10,RedHatAI/Qwen2.5-0.5B-quantized.w8a8,0,19,68,0,6
2025-04-09,RedHatAI/Qwen2.5-1.5B-FP8-dynamic,0,9,68,0,68
2025-04-10,RedHatAI/Qwen2.5-1.5B-FP8-dynamic,0,6,68,0,0
2025-04-09,RedHatAI/Qwen2.5-1.5B-quantized.w8a16,0,6,55,0,55
2025-04-10,RedHatAI/Qwen2.5-1.5B-quantized.w8a16,0,4,55,0,0
2025-04-09,RedHatAI/Qwen2.5-1.5B-quantized.w8a8,0,3,50,0,50
2025-04-10,RedHatAI/Qwen2.5-1.5B-quantized.w8a8,0,1,50,0,0
2025-04-09,RedHatAI/Qwen2.5-14B-FP8-dynamic,1,177,342,1,342
2025-04-10,RedHatAI/Qwen2.5-14B-FP8-dynamic,1,172,342,0,0
2025-04-09,RedHatAI/Qwen2.5-14B-quantized.w8a8,1,71,176,1,176
2025-04-10,RedHatAI/Qwen2.5-14B-quantized.w8a8,1,71,176,0,0
2025-04-09,RedHatAI/Qwen2.5-32B-quantized.w8a16,0,76,272,0,272
2025-04-10,RedHatAI/Qwen2.5-32B-quantized.w8a16,0,72,272,0,0
2025-04-09,RedHatAI/Qwen2.5-3B-FP8-dynamic,0,49,130,0,130
2025-04-10,RedHatAI/Qwen2.5-3B-FP8-dynamic,0,47,130,0,0
2025-04-09,RedHatAI/Qwen2.5-3B-quantized.w8a16,0,4,42,0,42
2025-04-10,RedHatAI/Qwen2.5-3B-quantized.w8a16,0,2,42,0,0
2025-04-09,RedHatAI/Qwen2.5-3B-quantized.w8a8,0,14,64,0,64
2025-04-10,RedHatAI/Qwen2.5-3B-quantized.w8a8,0,12,64,0,0
2025-04-09,RedHatAI/Qwen2.5-72B-FP8-dynamic,1,13,112,1,112
2025-04-10,RedHatAI/Qwen2.5-72B-FP8-dynamic,1,11,112,0,0
2025-04-09,RedHatAI/Qwen2.5-72B-quantized.w8a16,0,43,80,0,80
2025-04-10,RedHatAI/Qwen2.5-72B-quantized.w8a16,0,41,80,0,0
2025-04-09,RedHatAI/Qwen2.5-72B-quantized.w8a8,0,14,98,0,98
2025-04-10,RedHatAI/Qwen2.5-72B-quantized.w8a8,0,12,98,0,0
2025-04-09,RedHatAI/Qwen2.5-7B-FP8-dynamic,0,160,252,0,252
2025-04-10,RedHatAI/Qwen2.5-7B-FP8-dynamic,0,169,263,0,11
2025-04-09,RedHatAI/Qwen2.5-7B-quantized.w8a16,1,45,79,1,79
2025-04-10,RedHatAI/Qwen2.5-7B-quantized.w8a16,1,43,79,0,0
2025-04-09,RedHatAI/Qwen2.5-7B-quantized.w8a8,0,3307,3427,0,3427
2025-04-10,RedHatAI/Qwen2.5-7B-quantized.w8a8,0,3337,3459,0,32
2025-04-09,RedHatAI/Qwen2.5-VL-3B-Instruct-FP8-Dynamic,0,95,372,0,372
2025-04-10,RedHatAI/Qwen2.5-VL-3B-Instruct-FP8-Dynamic,0,100,377,0,5
2025-04-09,RedHatAI/Qwen2.5-VL-3B-Instruct-quantized.w4a16,0,199,639,0,639
2025-04-10,RedHatAI/Qwen2.5-VL-3B-Instruct-quantized.w4a16,0,181,639,0,0
2025-04-09,RedHatAI/Qwen2.5-VL-3B-Instruct-quantized.w8a8,0,313,588,0,588
2025-04-10,RedHatAI/Qwen2.5-VL-3B-Instruct-quantized.w8a8,0,330,607,0,19
2025-04-09,RedHatAI/Qwen2.5-VL-72B-Instruct-FP8-Dynamic,2,1539,3566,2,3566
2025-04-10,RedHatAI/Qwen2.5-VL-72B-Instruct-FP8-Dynamic,2,1530,3581,0,15
2025-04-09,RedHatAI/Qwen2.5-VL-72B-Instruct-quantized.w4a16,3,787,2036,3,2036
2025-04-10,RedHatAI/Qwen2.5-VL-72B-Instruct-quantized.w4a16,3,771,2036,0,0
2025-04-09,RedHatAI/Qwen2.5-VL-72B-Instruct-quantized.w8a8,0,2918,3725,0,3725
2025-04-10,RedHatAI/Qwen2.5-VL-72B-Instruct-quantized.w8a8,0,2906,3748,0,23
2025-04-09,RedHatAI/Qwen2.5-VL-7B-Instruct-FP8-Dynamic,0,1061,2029,0,2029
2025-04-10,RedHatAI/Qwen2.5-VL-7B-Instruct-FP8-Dynamic,0,1033,2038,0,9
2025-04-09,RedHatAI/Qwen2.5-VL-7B-Instruct-quantized.w4a16,3,1048,1515,3,1515
2025-04-10,RedHatAI/Qwen2.5-VL-7B-Instruct-quantized.w4a16,3,1041,1515,0,0
2025-04-09,RedHatAI/Qwen2.5-VL-7B-Instruct-quantized.w8a8,1,8201,8635,1,8635
2025-04-10,RedHatAI/Qwen2.5-VL-7B-Instruct-quantized.w8a8,1,8199,8644,0,9
2025-04-09,RedHatAI/SOLAR-10.7B-Instruct-v1.0-pruned50-quant-ds,5,0,237,5,237
2025-04-10,RedHatAI/SOLAR-10.7B-Instruct-v1.0-pruned50-quant-ds,5,0,237,0,0
2025-04-09,RedHatAI/SmolLM-1.7B-Instruct-quantized.w8a16,0,30,261,0,261
2025-04-10,RedHatAI/SmolLM-1.7B-Instruct-quantized.w8a16,0,28,261,0,0
2025-04-09,RedHatAI/SmolLM-1.7B-Instruct-quantized.w8a8,1,6,226,1,226
2025-04-10,RedHatAI/SmolLM-1.7B-Instruct-quantized.w8a8,1,4,226,0,0
2025-04-09,RedHatAI/SmolLM-135M-Instruct-quantized.w8a16,0,0,2,0,2
2025-04-10,RedHatAI/SmolLM-135M-Instruct-quantized.w8a16,0,0,2,0,0
2025-04-09,RedHatAI/SmolLM-135M-Instruct-quantized.w8a8,0,63,1594,0,1594
2025-04-10,RedHatAI/SmolLM-135M-Instruct-quantized.w8a8,0,59,1594,0,0
2025-04-09,RedHatAI/SmolLM-135M-q,0,0,0,0,0
2025-04-10,RedHatAI/SmolLM-135M-q,0,0,0,0,0
2025-04-09,RedHatAI/SmolLM-360M-Instruct-quantized.w8a8,0,39,254,0,254
2025-04-10,RedHatAI/SmolLM-360M-Instruct-quantized.w8a8,0,50,267,0,13
2025-04-09,RedHatAI/Sparse-Llama-3.1-8B-2of4,62,119,12473,62,12473
2025-04-10,RedHatAI/Sparse-Llama-3.1-8B-2of4,62,129,12485,0,12
2025-04-09,RedHatAI/Sparse-Llama-3.1-8B-evolcodealpaca-2of4,1,5,192,1,192
2025-04-10,RedHatAI/Sparse-Llama-3.1-8B-evolcodealpaca-2of4,1,5,192,0,0
2025-04-09,RedHatAI/Sparse-Llama-3.1-8B-evolcodealpaca-2of4-FP8-dynamic,0,3,100,0,100
2025-04-10,RedHatAI/Sparse-Llama-3.1-8B-evolcodealpaca-2of4-FP8-dynamic,0,1,100,0,0
2025-04-09,RedHatAI/Sparse-Llama-3.1-8B-evolcodealpaca-2of4-quantized.w4a16,0,6,92,0,92
2025-04-10,RedHatAI/Sparse-Llama-3.1-8B-evolcodealpaca-2of4-quantized.w4a16,0,4,92,0,0
2025-04-09,RedHatAI/Sparse-Llama-3.1-8B-gsm8k-2of4,1,10,369,1,369
2025-04-10,RedHatAI/Sparse-Llama-3.1-8B-gsm8k-2of4,1,8,369,0,0
2025-04-09,RedHatAI/Sparse-Llama-3.1-8B-gsm8k-2of4-FP8-dynamic,1,17,683,1,683
2025-04-10,RedHatAI/Sparse-Llama-3.1-8B-gsm8k-2of4-FP8-dynamic,1,15,683,0,0
2025-04-09,RedHatAI/Sparse-Llama-3.1-8B-gsm8k-2of4-quantized.w4a16,0,12,130,0,130
2025-04-10,RedHatAI/Sparse-Llama-3.1-8B-gsm8k-2of4-quantized.w4a16,0,11,131,0,1
2025-04-09,RedHatAI/Sparse-Llama-3.1-8B-ultrachat_200k-2of4,1,3,232,1,232
2025-04-10,RedHatAI/Sparse-Llama-3.1-8B-ultrachat_200k-2of4,1,1,232,0,0
2025-04-09,RedHatAI/Sparse-Llama-3.1-8B-ultrachat_200k-2of4-FP8-dynamic,1,16,167,1,167
2025-04-10,RedHatAI/Sparse-Llama-3.1-8B-ultrachat_200k-2of4-FP8-dynamic,1,14,167,0,0
2025-04-09,RedHatAI/Sparse-Llama-3.1-8B-ultrachat_200k-2of4-quantized.w4a16,3,59,2502,3,2502
2025-04-10,RedHatAI/Sparse-Llama-3.1-8B-ultrachat_200k-2of4-quantized.w4a16,3,57,2502,0,0
2025-04-09,RedHatAI/SparseLLama-2-7b-ultrachat_200k-pruned_50.2of4,0,2,213,0,213
2025-04-10,RedHatAI/SparseLLama-2-7b-ultrachat_200k-pruned_50.2of4,0,0,213,0,0
2025-04-09,RedHatAI/SparseLlama-2-7b-cnn-daily-mail-pruned_50.2of4,0,2,108,0,108
2025-04-10,RedHatAI/SparseLlama-2-7b-cnn-daily-mail-pruned_50.2of4,0,0,108,0,0
2025-04-09,RedHatAI/SparseLlama-2-7b-cnn-daily-mail-pruned_70,0,0,0,0,0
2025-04-10,RedHatAI/SparseLlama-2-7b-cnn-daily-mail-pruned_70,0,0,0,0,0
2025-04-09,RedHatAI/SparseLlama-2-7b-evolcodealpaca-pruned_50.2of4,0,3,108,0,108
2025-04-10,RedHatAI/SparseLlama-2-7b-evolcodealpaca-pruned_50.2of4,0,1,108,0,0
2025-04-09,RedHatAI/SparseLlama-3-8B-pruned_50.2of4,0,18,844,0,844
2025-04-10,RedHatAI/SparseLlama-3-8B-pruned_50.2of4,0,15,844,0,0
2025-04-09,RedHatAI/TinyLlama-1.1B-Chat-v0.4-pruned50-quant-ds,0,7,474,0,474
2025-04-10,RedHatAI/TinyLlama-1.1B-Chat-v0.4-pruned50-quant-ds,0,7,474,0,0
2025-04-09,RedHatAI/TinyLlama-1.1B-Chat-v1.0-marlin,1,3634,69611,1,69611
2025-04-10,RedHatAI/TinyLlama-1.1B-Chat-v1.0-marlin,1,3576,69606,0,-5
2025-04-09,RedHatAI/TinyLlama-1.1B-Chat-v1.0-pruned2.4,1,19,2962,1,2962
2025-04-10,RedHatAI/TinyLlama-1.1B-Chat-v1.0-pruned2.4,1,13,2962,0,0
2025-04-09,RedHatAI/bert-large-uncased-finetuned-squadv1,1,10,1388,1,1388
2025-04-10,RedHatAI/bert-large-uncased-finetuned-squadv1,1,10,1388,0,0
2025-04-09,RedHatAI/bge-base-en-v1.5-dense,0,4,131,0,131
2025-04-10,RedHatAI/bge-base-en-v1.5-dense,0,3,131,0,0
2025-04-09,RedHatAI/bge-base-en-v1.5-quant,4,597,172198,4,172198
2025-04-10,RedHatAI/bge-base-en-v1.5-quant,4,577,172198,0,0
2025-04-09,RedHatAI/bge-base-en-v1.5-sparse,1,3,30374,1,30374
2025-04-10,RedHatAI/bge-base-en-v1.5-sparse,1,2,30374,0,0
2025-04-09,RedHatAI/bge-large-en-v1.5-dense,0,1,147,0,147
2025-04-10,RedHatAI/bge-large-en-v1.5-dense,0,1,147,0,0
2025-04-09,RedHatAI/bge-large-en-v1.5-quant,21,48200,269599,21,269599
2025-04-10,RedHatAI/bge-large-en-v1.5-quant,21,48223,269622,0,23
2025-04-09,RedHatAI/bge-large-en-v1.5-sparse,3,3,28390,3,28390
2025-04-10,RedHatAI/bge-large-en-v1.5-sparse,3,1,28390,0,0
2025-04-09,RedHatAI/bge-small-en-v1.5-dense,0,0,108,0,108
2025-04-10,RedHatAI/bge-small-en-v1.5-dense,0,0,108,0,0
2025-04-09,RedHatAI/bge-small-en-v1.5-quant,9,1197,110681,9,110681
2025-04-10,RedHatAI/bge-small-en-v1.5-quant,9,1187,110685,0,4
2025-04-09,RedHatAI/bge-small-en-v1.5-sparse,4,4,32660,4,32660
2025-04-10,RedHatAI/bge-small-en-v1.5-sparse,4,1,32660,0,0
2025-04-09,RedHatAI/gemma-2-2b-it-FP8,1,1652,8507,1,8507
2025-04-10,RedHatAI/gemma-2-2b-it-FP8,1,1650,8511,0,4
2025-04-09,RedHatAI/gemma-2-2b-it-quantized.w4a16,1,1461,9561,1,9561
2025-04-10,RedHatAI/gemma-2-2b-it-quantized.w4a16,1,1459,9561,0,0
2025-04-09,RedHatAI/gemma-2-2b-it-quantized.w8a16,1,9,516,1,516
2025-04-10,RedHatAI/gemma-2-2b-it-quantized.w8a16,1,7,516,0,0
2025-04-09,RedHatAI/gemma-2-2b-it-quantized.w8a8,0,66,5105,0,5105
2025-04-10,RedHatAI/gemma-2-2b-it-quantized.w8a8,0,64,5105,0,0
2025-04-09,RedHatAI/gemma-2-2b-quantized.w8a16,0,43,394,0,394
2025-04-10,RedHatAI/gemma-2-2b-quantized.w8a16,0,41,394,0,0
2025-04-09,RedHatAI/gemma-2-9b-it-FP8,6,456,25423,6,25423
2025-04-10,RedHatAI/gemma-2-9b-it-FP8,6,456,25425,0,2
2025-04-09,RedHatAI/gemma-2-9b-it-quantized.w4a16,2,140,3727,2,3727
2025-04-10,RedHatAI/gemma-2-9b-it-quantized.w4a16,2,138,3727,0,0
2025-04-09,RedHatAI/gemma-2-9b-it-quantized.w8a16,1,643,10005,1,10005
2025-04-10,RedHatAI/gemma-2-9b-it-quantized.w8a16,1,643,10009,0,4
2025-04-09,RedHatAI/gemma-2-9b-it-quantized.w8a8,3,53,1682,3,1682
2025-04-10,RedHatAI/gemma-2-9b-it-quantized.w8a8,3,52,1682,0,0
2025-04-09,RedHatAI/granite-3.1-2b-base-FP8-dynamic,0,7,82,0,82
2025-04-10,RedHatAI/granite-3.1-2b-base-FP8-dynamic,0,7,83,0,1
2025-04-09,RedHatAI/granite-3.1-2b-base-quantized.w4a16,0,28,121,0,121
2025-04-10,RedHatAI/granite-3.1-2b-base-quantized.w4a16,0,27,121,0,0
2025-04-09,RedHatAI/granite-3.1-2b-base-quantized.w8a8,0,346,438,0,438
2025-04-10,RedHatAI/granite-3.1-2b-base-quantized.w8a8,0,344,438,0,0
2025-04-09,RedHatAI/granite-3.1-2b-instruct-FP8-dynamic,0,47,192,0,192
2025-04-10,RedHatAI/granite-3.1-2b-instruct-FP8-dynamic,0,37,193,0,1
2025-04-09,RedHatAI/granite-3.1-2b-instruct-quantized.w4a16,0,147,599,0,599
2025-04-10,RedHatAI/granite-3.1-2b-instruct-quantized.w4a16,0,138,609,0,10
2025-04-09,RedHatAI/granite-3.1-2b-instruct-quantized.w8a8,0,146,412,0,412
2025-04-10,RedHatAI/granite-3.1-2b-instruct-quantized.w8a8,0,133,412,0,0
2025-04-09,RedHatAI/granite-3.1-8b-base-FP8-dynamic,0,7,30,0,30
2025-04-10,RedHatAI/granite-3.1-8b-base-FP8-dynamic,0,7,30,0,0
2025-04-09,RedHatAI/granite-3.1-8b-base-quantized.w4a16,0,12,96,0,96
2025-04-10,RedHatAI/granite-3.1-8b-base-quantized.w4a16,0,13,98,0,2
2025-04-09,RedHatAI/granite-3.1-8b-base-quantized.w8a8,0,47,106,0,106
2025-04-10,RedHatAI/granite-3.1-8b-base-quantized.w8a8,0,46,106,0,0
2025-04-09,RedHatAI/granite-3.1-8b-instruct-FP8-dynamic,1,25,191,1,191
2025-04-10,RedHatAI/granite-3.1-8b-instruct-FP8-dynamic,1,24,192,0,1
2025-04-09,RedHatAI/granite-3.1-8b-instruct-quantized.w4a16,1,254,634,1,634
2025-04-10,RedHatAI/granite-3.1-8b-instruct-quantized.w4a16,1,251,634,0,0
2025-04-09,RedHatAI/granite-3.1-8b-instruct-quantized.w8a8,1,244,510,1,510
2025-04-10,RedHatAI/granite-3.1-8b-instruct-quantized.w8a8,1,229,510,0,0
2025-04-09,RedHatAI/llama-2-7b-chat-marlin,0,1437,18132,0,18132
2025-04-10,RedHatAI/llama-2-7b-chat-marlin,0,1437,18134,0,2
2025-04-09,RedHatAI/llama2.c-stories110M-pruned2.4,0,13,492,0,492
2025-04-10,RedHatAI/llama2.c-stories110M-pruned2.4,0,9,492,0,0
2025-04-09,RedHatAI/llama2.c-stories110M-pruned50,0,1117,10556,0,10556
2025-04-10,RedHatAI/llama2.c-stories110M-pruned50,0,1095,10556,0,0
2025-04-09,RedHatAI/mobilebert-uncased-finetuned-squadv1,1,5,1400,1,1400
2025-04-10,RedHatAI/mobilebert-uncased-finetuned-squadv1,1,5,1400,0,0
2025-04-09,RedHatAI/mpt-7b-chat-pruned50-quant-ds,4,8,769,4,769
2025-04-10,RedHatAI/mpt-7b-chat-pruned50-quant-ds,4,8,769,0,0
2025-04-09,RedHatAI/mpt-7b-gsm8k-pruned40-quant-ds,0,5,252,0,252
2025-04-10,RedHatAI/mpt-7b-gsm8k-pruned40-quant-ds,0,3,252,0,0
2025-04-09,RedHatAI/mpt-7b-gsm8k-pruned50-quant-ds,0,3,298,0,298
2025-04-10,RedHatAI/mpt-7b-gsm8k-pruned50-quant-ds,0,0,298,0,0
2025-04-09,RedHatAI/mpt-7b-gsm8k-pruned60-pt,0,2,281,0,281
2025-04-10,RedHatAI/mpt-7b-gsm8k-pruned60-pt,0,2,281,0,0
2025-04-09,RedHatAI/mpt-7b-gsm8k-pruned60-quant-ds,0,2,427,0,427
2025-04-10,RedHatAI/mpt-7b-gsm8k-pruned60-quant-ds,0,2,427,0,0
2025-04-09,RedHatAI/mpt-7b-gsm8k-pruned70-quant-ds,1,2,258,1,258
2025-04-10,RedHatAI/mpt-7b-gsm8k-pruned70-quant-ds,1,2,258,0,0
2025-04-09,RedHatAI/mpt-7b-gsm8k-pruned75-quant-ds,0,4,149,0,149
2025-04-10,RedHatAI/mpt-7b-gsm8k-pruned75-quant-ds,0,2,149,0,0
2025-04-09,RedHatAI/mpt-7b-gsm8k-pruned80-quant-ds,2,6,187,2,187
2025-04-10,RedHatAI/mpt-7b-gsm8k-pruned80-quant-ds,2,3,187,0,0
2025-04-09,RedHatAI/mpt-7b-gsm8k-pt,1,2,1759,1,1759
2025-04-10,RedHatAI/mpt-7b-gsm8k-pt,1,2,1759,0,0
2025-04-09,RedHatAI/mpt-7b-gsm8k-quant-ds,1,3,262,1,262
2025-04-10,RedHatAI/mpt-7b-gsm8k-quant-ds,1,2,262,0,0
2025-04-09,RedHatAI/oBERT-12-downstream-dense-QAT-squadv1,0,3,250,0,250
2025-04-10,RedHatAI/oBERT-12-downstream-dense-QAT-squadv1,0,2,250,0,0
2025-04-09,RedHatAI/oBERT-12-downstream-dense-squadv1,0,3,423,0,423
2025-04-10,RedHatAI/oBERT-12-downstream-dense-squadv1,0,3,423,0,0
2025-04-09,RedHatAI/oBERT-12-downstream-pruned-block4-80-QAT-squadv1,0,3,247,0,247
2025-04-10,RedHatAI/oBERT-12-downstream-pruned-block4-80-QAT-squadv1,0,3,247,0,0
2025-04-09,RedHatAI/oBERT-12-downstream-pruned-block4-80-squadv1,0,6,245,0,245
2025-04-10,RedHatAI/oBERT-12-downstream-pruned-block4-80-squadv1,0,6,245,0,0
2025-04-09,RedHatAI/oBERT-12-downstream-pruned-block4-90-QAT-squadv1,0,2,226,0,226
2025-04-10,RedHatAI/oBERT-12-downstream-pruned-block4-90-QAT-squadv1,0,2,226,0,0
2025-04-09,RedHatAI/oBERT-12-downstream-pruned-block4-90-squadv1,0,2,257,0,257
2025-04-10,RedHatAI/oBERT-12-downstream-pruned-block4-90-squadv1,0,2,257,0,0
2025-04-09,RedHatAI/oBERT-12-downstream-pruned-unstructured-80-mnli,0,2,271,0,271
2025-04-10,RedHatAI/oBERT-12-downstream-pruned-unstructured-80-mnli,0,2,271,0,0
2025-04-09,RedHatAI/oBERT-12-downstream-pruned-unstructured-80-qqp,0,2,246,0,246
2025-04-10,RedHatAI/oBERT-12-downstream-pruned-unstructured-80-qqp,0,2,246,0,0
2025-04-09,RedHatAI/oBERT-12-downstream-pruned-unstructured-80-squadv1,0,8,267,0,267
2025-04-10,RedHatAI/oBERT-12-downstream-pruned-unstructured-80-squadv1,0,7,267,0,0
2025-04-09,RedHatAI/oBERT-12-downstream-pruned-unstructured-90-mnli,0,5,12222,0,12222
2025-04-10,RedHatAI/oBERT-12-downstream-pruned-unstructured-90-mnli,0,5,12222,0,0
2025-04-09,RedHatAI/oBERT-12-downstream-pruned-unstructured-90-qqp,0,5,296,0,296
2025-04-10,RedHatAI/oBERT-12-downstream-pruned-unstructured-90-qqp,0,4,296,0,0
2025-04-09,RedHatAI/oBERT-12-downstream-pruned-unstructured-90-squadv1,0,11,340,0,340
2025-04-10,RedHatAI/oBERT-12-downstream-pruned-unstructured-90-squadv1,0,10,340,0,0
2025-04-09,RedHatAI/oBERT-12-downstream-pruned-unstructured-97-mnli,0,8,223,0,223
2025-04-10,RedHatAI/oBERT-12-downstream-pruned-unstructured-97-mnli,0,8,223,0,0
2025-04-09,RedHatAI/oBERT-12-downstream-pruned-unstructured-97-qqp,0,2,275,0,275
2025-04-10,RedHatAI/oBERT-12-downstream-pruned-unstructured-97-qqp,0,2,275,0,0
2025-04-09,RedHatAI/oBERT-12-downstream-pruned-unstructured-97-squadv1,0,3,257,0,257
2025-04-10,RedHatAI/oBERT-12-downstream-pruned-unstructured-97-squadv1,0,3,257,0,0
2025-04-09,RedHatAI/oBERT-12-upstream-pretrained-dense,0,2,623,0,623
2025-04-10,RedHatAI/oBERT-12-upstream-pretrained-dense,0,2,623,0,0
2025-04-09,RedHatAI/oBERT-12-upstream-pruned-unstructured-90,0,5,675,0,675
2025-04-10,RedHatAI/oBERT-12-upstream-pruned-unstructured-90,0,5,675,0,0
2025-04-09,RedHatAI/oBERT-12-upstream-pruned-unstructured-90-finetuned-mnli,0,3,294,0,294
2025-04-10,RedHatAI/oBERT-12-upstream-pruned-unstructured-90-finetuned-mnli,0,3,294,0,0
2025-04-09,RedHatAI/oBERT-12-upstream-pruned-unstructured-90-finetuned-mnli-v2,0,5,252,0,252
2025-04-10,RedHatAI/oBERT-12-upstream-pruned-unstructured-90-finetuned-mnli-v2,0,5,252,0,0
2025-04-09,RedHatAI/oBERT-12-upstream-pruned-unstructured-90-finetuned-qqp,0,4,255,0,255
2025-04-10,RedHatAI/oBERT-12-upstream-pruned-unstructured-90-finetuned-qqp,0,4,255,0,0
2025-04-09,RedHatAI/oBERT-12-upstream-pruned-unstructured-90-finetuned-qqp-v2,0,3,219,0,219
2025-04-10,RedHatAI/oBERT-12-upstream-pruned-unstructured-90-finetuned-qqp-v2,0,3,219,0,0
2025-04-09,RedHatAI/oBERT-12-upstream-pruned-unstructured-90-finetuned-squadv1,0,2,304,0,304
2025-04-10,RedHatAI/oBERT-12-upstream-pruned-unstructured-90-finetuned-squadv1,0,2,304,0,0
2025-04-09,RedHatAI/oBERT-12-upstream-pruned-unstructured-90-finetuned-squadv1-v2,0,3,231,0,231
2025-04-10,RedHatAI/oBERT-12-upstream-pruned-unstructured-90-finetuned-squadv1-v2,0,2,231,0,0
2025-04-09,RedHatAI/oBERT-12-upstream-pruned-unstructured-90-v2,0,4,308,0,308
2025-04-10,RedHatAI/oBERT-12-upstream-pruned-unstructured-90-v2,0,4,308,0,0
2025-04-09,RedHatAI/oBERT-12-upstream-pruned-unstructured-97,0,3,590,0,590
2025-04-10,RedHatAI/oBERT-12-upstream-pruned-unstructured-97,0,3,590,0,0
2025-04-09,RedHatAI/oBERT-12-upstream-pruned-unstructured-97-finetuned-mnli,0,2,315,0,315
2025-04-10,RedHatAI/oBERT-12-upstream-pruned-unstructured-97-finetuned-mnli,0,2,315,0,0
2025-04-09,RedHatAI/oBERT-12-upstream-pruned-unstructured-97-finetuned-mnli-v2,0,3,235,0,235
2025-04-10,RedHatAI/oBERT-12-upstream-pruned-unstructured-97-finetuned-mnli-v2,0,3,235,0,0
2025-04-09,RedHatAI/oBERT-12-upstream-pruned-unstructured-97-finetuned-qqp,0,5,317,0,317
2025-04-10,RedHatAI/oBERT-12-upstream-pruned-unstructured-97-finetuned-qqp,0,5,317,0,0
2025-04-09,RedHatAI/oBERT-12-upstream-pruned-unstructured-97-finetuned-qqp-v2,0,5,240,0,240
2025-04-10,RedHatAI/oBERT-12-upstream-pruned-unstructured-97-finetuned-qqp-v2,0,5,240,0,0
2025-04-09,RedHatAI/oBERT-12-upstream-pruned-unstructured-97-finetuned-squadv1,0,2,371,0,371
2025-04-10,RedHatAI/oBERT-12-upstream-pruned-unstructured-97-finetuned-squadv1,0,2,371,0,0
2025-04-09,RedHatAI/oBERT-12-upstream-pruned-unstructured-97-finetuned-squadv1-v2,0,3,255,0,255
2025-04-10,RedHatAI/oBERT-12-upstream-pruned-unstructured-97-finetuned-squadv1-v2,0,3,255,0,0
2025-04-09,RedHatAI/oBERT-12-upstream-pruned-unstructured-97-v2,0,5,226,0,226
2025-04-10,RedHatAI/oBERT-12-upstream-pruned-unstructured-97-v2,0,5,226,0,0
2025-04-09,RedHatAI/oBERT-3-downstream-dense-QAT-squadv1,0,5,245,0,245
2025-04-10,RedHatAI/oBERT-3-downstream-dense-QAT-squadv1,0,5,245,0,0
2025-04-09,RedHatAI/oBERT-3-downstream-dense-squadv1,0,2,2542,0,2542
2025-04-10,RedHatAI/oBERT-3-downstream-dense-squadv1,0,2,2542,0,0
2025-04-09,RedHatAI/oBERT-3-downstream-pruned-block4-80-QAT-squadv1,0,5,246,0,246
2025-04-10,RedHatAI/oBERT-3-downstream-pruned-block4-80-QAT-squadv1,0,5,246,0,0
2025-04-09,RedHatAI/oBERT-3-downstream-pruned-block4-80-squadv1,0,3,236,0,236
2025-04-10,RedHatAI/oBERT-3-downstream-pruned-block4-80-squadv1,0,2,236,0,0
2025-04-09,RedHatAI/oBERT-3-downstream-pruned-block4-90-QAT-squadv1,0,3,266,0,266
2025-04-10,RedHatAI/oBERT-3-downstream-pruned-block4-90-QAT-squadv1,0,3,266,0,0
2025-04-09,RedHatAI/oBERT-3-downstream-pruned-block4-90-squadv1,0,2,255,0,255
2025-04-10,RedHatAI/oBERT-3-downstream-pruned-block4-90-squadv1,0,2,255,0,0
2025-04-09,RedHatAI/oBERT-3-downstream-pruned-unstructured-80-squadv1,0,2,241,0,241
2025-04-10,RedHatAI/oBERT-3-downstream-pruned-unstructured-80-squadv1,0,2,241,0,0
2025-04-09,RedHatAI/oBERT-3-downstream-pruned-unstructured-90-squadv1,0,3,236,0,236
2025-04-10,RedHatAI/oBERT-3-downstream-pruned-unstructured-90-squadv1,0,3,236,0,0
2025-04-09,RedHatAI/oBERT-3-upstream-pretrained-dense,0,3,1239,0,1239
2025-04-10,RedHatAI/oBERT-3-upstream-pretrained-dense,0,3,1239,0,0
2025-04-09,RedHatAI/oBERT-6-downstream-dense-QAT-squadv1,0,5,238,0,238
2025-04-10,RedHatAI/oBERT-6-downstream-dense-QAT-squadv1,0,5,238,0,0
2025-04-09,RedHatAI/oBERT-6-downstream-dense-squadv1,0,5,611,0,611
2025-04-10,RedHatAI/oBERT-6-downstream-dense-squadv1,0,5,611,0,0
2025-04-09,RedHatAI/oBERT-6-downstream-pruned-block4-80-QAT-squadv1,0,6,262,0,262
2025-04-10,RedHatAI/oBERT-6-downstream-pruned-block4-80-QAT-squadv1,0,6,262,0,0
2025-04-09,RedHatAI/oBERT-6-downstream-pruned-block4-80-squadv1,1,24,367,1,367
2025-04-10,RedHatAI/oBERT-6-downstream-pruned-block4-80-squadv1,1,19,367,0,0
2025-04-09,RedHatAI/oBERT-6-downstream-pruned-block4-90-QAT-squadv1,0,3,251,0,251
2025-04-10,RedHatAI/oBERT-6-downstream-pruned-block4-90-QAT-squadv1,0,3,251,0,0
2025-04-09,RedHatAI/oBERT-6-downstream-pruned-block4-90-squadv1,0,3,247,0,247
2025-04-10,RedHatAI/oBERT-6-downstream-pruned-block4-90-squadv1,0,3,247,0,0
2025-04-09,RedHatAI/oBERT-6-downstream-pruned-unstructured-80-squadv1,0,4,273,0,273
2025-04-10,RedHatAI/oBERT-6-downstream-pruned-unstructured-80-squadv1,0,4,273,0,0
2025-04-09,RedHatAI/oBERT-6-downstream-pruned-unstructured-90-squadv1,0,6,278,0,278
2025-04-10,RedHatAI/oBERT-6-downstream-pruned-unstructured-90-squadv1,0,6,278,0,0
2025-04-09,RedHatAI/oBERT-6-upstream-pretrained-dense,0,6,595,0,595
2025-04-10,RedHatAI/oBERT-6-upstream-pretrained-dense,0,6,595,0,0
2025-04-09,RedHatAI/oBERT-teacher-mnli,0,4,470,0,470
2025-04-10,RedHatAI/oBERT-teacher-mnli,0,4,470,0,0
2025-04-09,RedHatAI/oBERT-teacher-qqp,0,2,516,0,516
2025-04-10,RedHatAI/oBERT-teacher-qqp,0,2,516,0,0
2025-04-09,RedHatAI/oBERT-teacher-squadv1,0,8,6799,0,6799
2025-04-10,RedHatAI/oBERT-teacher-squadv1,0,7,6799,0,0
2025-04-09,RedHatAI/phi-2-pruned50,0,4,304,0,304
2025-04-10,RedHatAI/phi-2-pruned50,0,2,304,0,0
2025-04-09,RedHatAI/phi-2-super-marlin,1,3,275,1,275
2025-04-10,RedHatAI/phi-2-super-marlin,1,1,275,0,0
2025-04-09,RedHatAI/pixtral-12b-FP8-dynamic,8,8202,40984,8,40984
2025-04-10,RedHatAI/pixtral-12b-FP8-dynamic,8,8188,40984,0,0
2025-04-09,RedHatAI/pixtral-12b-quantized.w4a16,1,115,419,1,419
2025-04-10,RedHatAI/pixtral-12b-quantized.w4a16,1,112,419,0,0
2025-04-09,RedHatAI/pixtral-12b-quantized.w8a8,0,34,243,0,243
2025-04-10,RedHatAI/pixtral-12b-quantized.w8a8,0,33,243,0,0
2025-04-09,RedHatAI/sst2-distilbert-sparse-blog,4,3,407,4,407
2025-04-10,RedHatAI/sst2-distilbert-sparse-blog,4,3,407,0,0
2025-04-09,RedHatAI/starcoder2-15b-FP8,0,37,2300,0,2300
2025-04-10,RedHatAI/starcoder2-15b-FP8,0,33,2300,0,0
2025-04-09,RedHatAI/starcoder2-15b-quantized.w8a16,0,4,1249,0,1249
2025-04-10,RedHatAI/starcoder2-15b-quantized.w8a16,0,1,1249,0,0
2025-04-09,RedHatAI/starcoder2-15b-quantized.w8a8,0,13,148,0,148
2025-04-10,RedHatAI/starcoder2-15b-quantized.w8a8,0,11,148,0,0
2025-04-09,RedHatAI/starcoder2-3b-FP8,0,74,348,0,348
2025-04-10,RedHatAI/starcoder2-3b-FP8,0,72,348,0,0
2025-04-09,RedHatAI/starcoder2-3b-quantized.w8a16,0,6,209,0,209
2025-04-10,RedHatAI/starcoder2-3b-quantized.w8a16,0,4,209,0,0
2025-04-09,RedHatAI/starcoder2-3b-quantized.w8a8,0,37,259,0,259
2025-04-10,RedHatAI/starcoder2-3b-quantized.w8a8,0,35,259,0,0
2025-04-09,RedHatAI/starcoder2-7b-FP8,0,4,175,0,175
2025-04-10,RedHatAI/starcoder2-7b-FP8,0,2,175,0,0
2025-04-09,RedHatAI/starcoder2-7b-quantized.w8a16,0,5,235,0,235
2025-04-10,RedHatAI/starcoder2-7b-quantized.w8a16,0,3,235,0,0
2025-04-09,RedHatAI/starcoder2-7b-quantized.w8a8,0,34,224,0,224
2025-04-10,RedHatAI/starcoder2-7b-quantized.w8a8,0,32,224,0,0
2025-04-09,RedHatAI/whisper-large-v2-W4A16-G128,1,10,99,1,99
2025-04-10,RedHatAI/whisper-large-v2-W4A16-G128,1,11,100,0,1
2025-04-09,RedHatAI/yi-34b-chat-marlin,0,0,100,0,100
2025-04-10,RedHatAI/yi-34b-chat-marlin,0,0,100,0,0
2025-04-09,RedHatAI/zephyr-7b-beta-marlin,0,122,51564,0,51564
2025-04-10,RedHatAI/zephyr-7b-beta-marlin,0,120,51564,0,0
2025-04-09,RedHatAI/zephyr-7b-beta-pruned50-quant-ds,0,2,165,0,165
2025-04-10,RedHatAI/zephyr-7b-beta-pruned50-quant-ds,0,2,165,0,0
2025-04-09,RedHatAI/zephyr-beta-7b-marlin,0,0,180,0,180
2025-04-10,RedHatAI/zephyr-beta-7b-marlin,0,0,180,0,0
